###########################################################
#                                                         #
#   ╬                  ¶  ¶              ¶                #
#         O                      ¶                        #
#                                                         #
#    ¶  ¶               ¶                          ©©©©©©©#
#                                             ¶    ©""""""#
#           """"""""     ¶         ☼"""""       ¶  ©"""¥""#
#     O     """"""""             """""""""         ©""""""#
#©©©© ©©©©© """"""©©                               ©""""""#
#"""""""""© """"""☼©                               ©""""""#
#"""""""""©                      ©©©©©©©©          ©""""""#
#"""""""""©               ¶      ©      ©          ©""""""#
#"""""""""©            ¶¶¶       ©  ⌂   ©☼         ©""""""#
#"""""""""©          ¶¶¶         ©      ©©©©       ©""""""#
#"""""""""©                      O                 ©""""""#
#"""""""""©O                                   """""""""""#
#"""""""""                                     """""""""""#
#"""""""""©                                    """""""""""#
###########################################################