###########################################################
#                                                         #
#   ╬                  ¶  ¶              ¶                #
#         O                      ¶                        #
#                                                         #
#    ¶  ¶               ¶                          ©©©©©©©#
#                                             ¶    ©""""""#
#           """"""""     ¶         °"""""       ¶  ©"""¥""#
#     O     """"""""             """""""""         ©""""""#
#©©©© ©©©©© """"""©©                               ©""""""#
#"""""""""© """"""°©                               ©""""""#
#"""""""""©                      ©©©©©©©©          ©""""""#
#"""""""""©               ¶      ©  / \ ©          ©""""""#
#"""""""""©            ¶¶¶       ©  |_| ©°         ©""""""#
#"""""""""©          ¶¶¶         ©      ©©©©       ©""""""#
#"""""""""©                      O                 ©""""""#
#"""""""""©O                                   """""""""""#
#"""""""""                                     """""""""""#
#"""""""""©                                    """""""""""#
###########################################################