###########################################################
#                                                         #
#                                                         #
#	                                                        #
#                                                         #
#                                                         #
#                                                         #
#                                                         #
#                                                         #
#                                                         #
#                                                         #
#                                                         #
#                                                         #
#	                                                        #
#	                                                        #
#	                                                        #
#                                                         #
#                                                         #
#                                                         #
###########################################################
 
