###########################################################
#                                                         #
#   ╬                  ¶  ¶              ¶                #
#         O                      ¶                        #
#                                                         #
#    ¶  ¶               ¶                          ©©©©©©©#
#                                             ¶    ©""""""#
#           """"""""     ¶         ☼"""""       ¶  ©"""¥""#
#     O     """"""""             """""""""         ©""""""#
#©©©© ©©©©© """"""©©                               ©""""""#
#~~~~~~~~~© """"""☼©                               ©""""""#
#~~~~~~~~~©                      ©©©©©©©©          ©""""""#
#~~~~~~~~~©               ¶      ©      ©          ©""""""#
#~~~~~~~~~©            ¶¶¶       ©  ⌂   ©☼         ©""""""#
#~~~~~~~~~©          ¶¶¶         ©      ©©©©       ©""""""#
#~~~~~~~~~©                      O                 ©""""""#
#~~~~~~~~~©O                                   """""""""""#
#~~~~~~~~~                                     """""""""""#
#~~~~~~~~~©                                    """""""""""#
###########################################################