###########################################################
#							  #
#	  						  #
#	 _____					  	  #
#	 |   |					  	  #
#	 |   |					 	  #
# 							  #
#							  #
#			""""""				  #
#			""""""				  #
#			""""""				  #
#			""""""""""©©©			  #
#				""""©			  #
#	""""			""""©			  #
#	""""						  #
#	""""    """"					  #
#		""""					  #
#		""""					  #
#							  #
###########################################################
 